

NO ./path_to_the_north_texture.xpm
SO ./path_to_the_south_texture.xpm
WE ./path_to_the_west_texture.xpm
EA ./path_to_the_east_texture.xpm
F 255,255,255
C 0,255,0
                                  
1111111111111111111111111111111111
100000001100000000000000000000001
101100000111000000000000000000011
100100000000000000000000111111111 
111111111011000N01110000000000001 
100000000011000001110111111111111 
1111011111111101110000001000111111
1111111111111111111111111111111111 