
SO ./texture/1c61b0435af5cc9101a1a3364ae31ab.xpm
NO  ./ddssssssss.xpm
EA ./texture/ross-el1eruXQVNkam3hE-unsplash.xpm
WE ./texture/sprited.xpm.xpm
C 0,19,255
F 255,128,251

111111111111111111111111111111111
100000001100000000000000000000001
101100000111000000000000000000011
100100000000000000000000111111111 
111111111011000N01110000000000001 
100000000011000001110111111111111 
1111011111111101110000001000111111
1111111111111111111111111111111111 