
SO ./texture/1c61b0435af5cc9101a1a3364ae31ab.xpm
NO  ./ddssssssss.xpm
EA ./texture/ross-el1eruXQVNkam3hE-unsplash.xpm
WE ./texture/sprited.xpm.xpm
C 0,19,255
F 255,128,251

 111111111111111111111111
1000000000110000000100001
1011000001110000N00010001  
100100000000000000000001111111111
111111111011000001110000000000001
100000000011000001110111111111111
11110111111111011100000010001
11110111111111011101010010001
1100000011 11011100000010001
10000000001100001100000010001
10000000100000001101010010001
110000011101010111111111000111 
11110111 1110101 101111010001
11111111 1111111 111111111111